   BBBBBBBBBBBBBBBBBBBBBBBBBBBBBB
   B                            B
   B                            B
   B                            B
   B                            B
   B                            B
   B                            B                            
   B       P                    B
   B      GGGG                  B
   B       DD           GG      B
   B                            B
GGGGGGGG         GG          GG B
DDDDDDDDG       GD              B
DDDDDDD    G  GGDD    GG  GG    B
DDDDD      D  DDDD    DD  DDG   B
DDDDD   GGGD  DDDDGG  DD  DDDG  B
DDDDDGGGDDDDKKDDDDDDKKDDKKDDDDKKB